80 80 80 80 80 80 80 80 80 80 80 80 80 80 80 80 80 80 80 80 80 80 80 80 80 80 80 80 80 80 80 80 80 80 80 80 80 80 80 80 80 80 80 80 80 80 80 80 80 80 
80 77 70 70 70 70 70 70 70 70 55 55 55 55 55 55 80 80 80 80 80 33 36 35 80 80 80 55 55 55 55 55 55 55 55 55 55 55 55 55 55 55 55 55 55 55 55 55 66 80 
80 67 85 86 85 85 93 89 89 97 0 0 0 0 0 0 59 80 80 80 80 28 28 28 80 80 55 0 0 0 0 0 0 0 0 42 0 0 0 0 0 0 42 0 42 0 0 0 57 80 
80 67 86 91 88 86 88 89 85 94 0 0 0 87 0 0 0 0 55 80 80 80 29 80 80 55 0 0 0 0 98 0 0 0 0 0 0 0 42 0 0 0 0 0 0 0 0 0 57 80 
80 67 89 89 85 88 88 92 89 97 0 0 0 0 0 0 0 87 0 55 80 80 29 80 55 0 0 0 0 0 0 0 0 0 0 42 0 0 0 0 42 0 0 25 24 26 0 0 57 80 
80 67 85 88 91 86 85 89 89 94 0 0 87 0 0 0 0 0 0 0 55 80 29 80 0 98 12 87 0 0 0 0 0 87 0 0 106 15 14 14 16 0 104 22 27 22 103 0 57 80 
80 67 90 86 85 89 86 89 85 97 0 0 0 0 0 98 12 12 12 12 12 0 0 0 98 52 50 51 0 0 0 0 0 0 0 104 112 17 13 11 17 111 107 21 20 21 103 0 57 80 
80 67 86 85 88 89 86 89 89 0 0 0 0 0 98 50 51 51 50 49 52 87 0 98 50 51 52 50 87 0 0 0 0 0 0 104 112 11 13 10 13 112 112 112 112 112 103 0 57 80 
80 67 88 89 86 97 0 96 97 0 0 0 0 51 51 51 50 51 50 49 52 52 50 52 51 52 49 52 51 87 0 0 0 98 0 0 105 108 112 110 105 105 105 105 105 105 103 0 57 80 
80 67 97 0 0 0 0 0 0 0 0 0 120 52 50 51 51 52 51 49 50 52 49 49 52 50 52 49 51 50 87 0 0 0 0 0 0 104 112 103 0 42 0 15 16 0 0 42 57 80 
80 56 0 0 0 0 98 0 0 87 0 0 0 120 49 109 120 49 49 50 49 49 109 1 120 49 49 50 51 50 109 1 0 0 0 0 0 104 112 103 0 0 0 11 11 0 0 0 57 80 
80 56 0 98 0 0 0 0 0 0 0 0 0 0 0 0 53 53 53 53 53 53 53 53 53 53 53 53 53 53 53 53 0 0 0 0 0 104 112 103 0 42 0 11 11 0 0 0 57 80 
80 56 0 0 0 0 0 0 0 0 0 0 0 0 53 53 80 80 80 80 80 80 80 80 80 80 80 80 80 80 80 80 53 0 0 0 0 104 112 103 42 0 104 11 11 103 41 0 57 80 
80 56 0 0 0 0 0 0 0 0 0 87 0 53 80 80 80 80 80 80 80 80 80 80 55 55 55 55 55 55 80 80 80 53 0 0 0 104 112 111 106 106 107 10 11 103 0 0 57 80 
80 63 53 53 53 29 29 53 53 53 53 53 53 80 80 80 80 55 55 55 55 55 55 55 0 127 127 127 0 0 55 80 80 80 53 0 0 104 112 112 112 105 105 105 105 0 0 0 57 80 
80 80 80 80 80 29 29 80 80 80 80 80 80 80 80 55 55 0 0 0 87 0 0 0 0 122 122 122 127 0 0 55 80 80 80 53 0 0 0 104 112 15 14 16 0 41 0 0 57 80 
80 80 80 80 80 29 29 80 80 80 80 80 80 80 55 0 40 39 0 0 0 0 0 0 0 128 127 122 127 127 0 0 55 80 80 80 53 41 0 104 112 31 31 31 103 0 0 0 57 80 
80 62 55 55 55 29 29 55 55 80 80 80 55 55 0 0 37 38 0 40 39 0 0 0 127 122 124 122 122 124 126 0 0 55 80 80 80 53 53 104 112 31 30 31 103 0 0 0 57 80 
80 56 0 0 0 0 0 0 0 55 55 55 0 0 0 40 39 0 0 37 38 0 0 0 125 123 122 123 122 122 126 128 0 0 55 80 80 80 80 0 105 105 105 105 0 0 45 0 57 80 
80 56 0 0 0 48 0 48 0 0 0 0 0 46 0 37 38 0 40 39 0 0 0 0 0 128 122 122 122 124 126 0 0 0 0 55 80 80 80 53 0 0 0 0 0 0 0 0 57 80 
80 56 0 47 0 0 0 47 0 0 46 0 0 98 47 0 0 0 37 38 0 0 0 98 0 127 126 127 127 127 0 0 0 0 0 0 55 55 80 80 53 53 45 0 0 40 39 45 57 80 
80 56 0 0 87 0 0 0 0 0 0 0 87 0 46 0 87 0 0 0 0 0 0 0 0 0 0 0 0 0 0 0 0 0 0 0 0 0 80 80 80 80 53 53 45 37 38 0 57 80 
80 56 48 0 46 0 0 48 0 0 0 0 48 0 0 0 0 0 0 0 15 14 14 14 14 16 0 0 0 0 0 0 0 0 0 0 47 0 55 55 80 80 80 80 53 53 0 42 57 80 
80 56 0 0 0 0 98 0 0 46 46 0 0 0 47 0 98 0 113 122 17 11 17 17 11 17 116 116 116 116 14 14 14 14 116 0 0 0 0 0 55 55 80 80 80 80 53 53 64 80 
80 56 0 0 47 0 0 47 0 0 0 47 0 0 48 0 0 0 113 122 11 10 11 11 10 11 128 122 122 127 31 31 31 31 122 115 0 0 0 46 0 0 55 55 80 80 80 80 80 80 
80 56 48 0 0 0 0 0 0 0 0 87 0 0 0 0 0 0 113 122 122 122 122 122 122 122 122 122 122 124 31 31 30 31 130 115 0 87 0 0 0 0 0 0 55 80 80 80 80 80 
80 56 0 0 0 48 0 0 48 0 0 0 0 0 0 0 48 48 0 114 114 114 114 114 122 122 114 114 114 118 123 122 122 122 122 115 0 0 0 0 0 0 47 0 0 80 80 80 80 80 
80 56 0 0 0 0 0 0 87 0 0 48 0 47 0 48 0 0 0 0 0 0 0 116 122 122 0 0 0 0 114 114 114 114 114 0 0 0 0 0 98 0 0 0 0 80 80 80 80 80 
80 56 0 47 0 0 48 0 0 48 0 0 0 0 0 98 0 48 0 0 0 0 116 122 122 114 0 0 0 0 0 98 0 0 0 0 0 0 0 0 0 0 47 0 0 80 80 80 80 80 
80 56 0 0 47 0 0 98 0 0 0 0 47 0 0 0 0 0 0 0 0 116 122 122 114 0 0 46 0 87 0 0 0 0 0 0 0 87 0 87 0 0 0 0 80 62 55 55 66 80 
80 56 0 87 48 0 0 0 47 0 0 0 48 98 0 48 0 0 0 0 116 122 122 114 0 0 0 0 0 0 0 98 0 0 0 46 0 0 0 0 0 46 0 0 80 56 0 0 57 80 
80 56 0 0 0 48 0 0 0 48 0 0 0 0 0 0 0 0 0 116 122 122 114 0 0 98 0 0 0 0 14 14 14 14 0 0 0 0 47 0 0 0 28 28 28 28 0 0 57 80 
80 56 0 0 0 0 0 0 24 24 24 24 24 24 24 24 24 0 116 122 122 114 0 0 0 0 0 0 48 0 11 11 17 13 0 0 0 0 0 0 0 0 28 28 28 28 0 87 57 80 
80 56 0 98 0 98 0 0 27 22 27 22 21 22 27 22 27 116 122 122 114 0 0 0 0 48 0 0 0 0 11 10 13 11 126 122 115 87 0 0 0 0 0 80 80 56 0 0 57 80 
80 56 0 0 0 0 0 113 21 20 21 22 22 21 22 20 21 126 122 122 116 116 116 116 116 116 116 116 116 116 116 116 116 116 122 122 115 0 0 53 53 53 53 80 80 60 0 0 57 80 
80 56 0 0 0 0 0 113 122 122 122 122 122 122 122 122 122 122 122 122 122 122 122 122 122 122 122 122 122 122 122 123 122 122 122 130 115 0 53 80 80 80 80 80 60 0 0 0 57 80 
80 56 0 0 87 0 0 0 114 114 114 114 114 114 114 114 114 114 114 114 114 114 114 114 114 114 114 114 114 114 114 114 114 114 114 114 0 58 80 80 80 55 55 55 0 0 0 0 57 80 
80 56 0 41 0 41 0 45 0 45 0 0 0 0 0 0 0 0 0 0 0 0 0 0 0 98 0 0 0 0 0 98 0 0 0 0 58 80 80 80 60 0 0 0 0 98 0 0 57 80 
80 56 0 0 0 0 0 0 0 0 0 0 0 0 0 98 0 0 0 0 0 87 0 0 0 0 0 0 0 0 0 0 0 0 0 58 80 80 80 60 0 0 0 0 0 0 0 0 57 80 
80 56 0 41 0 41 0 45 0 45 0 0 87 0 0 0 0 0 0 0 0 0 0 0 0 0 0 0 0 0 0 0 0 0 58 80 80 80 55 0 0 98 0 0 0 0 87 0 57 80 
80 56 0 0 0 0 0 0 0 0 0 0 0 0 0 0 0 0 87 0 0 95 85 89 85 94 0 0 95 85 89 88 88 68 80 80 80 60 0 0 0 0 0 87 0 0 0 0 57 80 
80 56 0 41 0 41 0 45 0 45 0 0 0 0 0 0 0 0 0 0 95 88 89 86 90 88 94 95 89 89 86 68 68 80 80 80 77 85 85 0 0 87 0 0 0 0 98 0 57 80 
80 56 0 0 0 0 0 0 0 0 0 0 98 0 0 0 0 0 0 95 89 89 89 89 86 85 89 88 89 92 89 80 80 80 80 70 86 86 86 85 0 0 0 0 0 0 0 0 57 80 
80 56 0 41 0 41 0 45 0 45 0 0 0 0 0 0 0 0 95 85 89 85 89 93 89 88 91 86 89 89 68 80 80 77 70 88 92 85 86 88 0 0 0 98 0 0 0 0 57 80 
80 56 0 0 0 0 0 0 0 0 0 0 0 0 0 95 94 95 89 91 85 85 86 89 71 68 68 68 68 68 80 77 70 86 86 86 89 86 86 88 85 0 0 0 0 0 0 0 57 80 
80 56 0 41 0 41 0 45 0 45 0 0 0 0 0 86 88 89 85 88 85 88 85 88 69 80 80 80 80 80 80 67 86 91 86 88 89 89 86 88 85 0 0 0 0 0 0 0 57 80 
80 56 0 0 0 0 0 0 0 0 0 0 0 0 95 85 92 89 85 85 89 85 93 86 69 80 80 33 36 35 80 67 85 86 88 88 88 89 88 88 88 85 0 0 0 0 87 0 57 80 
80 56 0 0 87 0 0 0 87 0 0 0 0 95 85 89 85 90 88 93 89 85 85 88 69 80 80 28 28 28 28 28 86 90 86 86 89 92 89 89 88 93 85 0 0 0 0 0 57 80 
80 63 53 53 53 53 53 53 53 53 53 53 53 68 68 68 68 68 68 68 68 68 68 68 79 80 80 80 80 80 80 78 68 68 68 68 68 68 68 68 68 68 68 53 53 53 53 53 64 80 
80 80 80 80 80 80 80 80 80 80 80 80 80 80 80 80 80 80 80 80 80 80 80 80 80 80 80 80 80 80 80 80 80 80 80 80 80 80 80 80 80 80 80 80 80 80 80 80 80 80 
